28 13 33 1 28 16 16
0 1 2 3 4 5 6 7 1 1 4 5 2 3 1 1 6 7 1 1 2 3 6 7 1 1 1 1 2 3 0 0 8 
0 1 9 10 11 12 6 7 1 1 11 12 9 10 1 1 6 7 1 1 9 10 6 7 1 1 1 1 9 10 0 0 8 
13 14 4 5 1 1 6 7 15 14 2 3 1 1 1 1 6 7 2 3 1 1 6 7 15 14 2 3 1 1 0 0 8 
16 17 11 12 1 1 6 7 18 19 9 10 1 1 1 1 6 7 9 10 1 1 6 7 18 19 9 10 1 1 0 0 8 
20 21 1 1 2 3 6 7 18 19 1 1 22 23 22 23 6 7 4 5 1 1 6 7 18 19 22 23 1 1 0 0 8 
0 0 1 1 9 10 0 0 0 0 1 1 0 0 0 0 0 0 11 12 1 1 0 0 0 0 0 0 1 1 0 0 8 
0 1 1 1 18 19 6 7 0 0 1 1 1 1 0 0 0 1 22 23 15 14 0 0 4 5 15 14 1 1 0 0 8 
0 1 1 1 0 0 6 7 0 0 1 1 1 1 0 0 0 1 0 0 18 19 0 0 11 12 18 19 24 0 0 0 8 
0 1 2 3 4 5 6 7 0 0 1 1 2 3 0 0 0 1 1 1 18 19 0 0 1 1 25 26 6 7 0 0 8 
0 1 9 10 11 12 6 7 0 0 1 1 9 10 0 0 0 1 1 1 0 0 0 0 1 1 26 1 6 7 0 0 8 
0 1 15 14 1 1 6 7 0 0 1 1 1 1 0 0 0 1 1 1 1 1 1 1 25 26 1 1 6 7 0 0 8 
0 1 18 19 1 1 6 7 0 0 1 1 1 1 0 0 27 1 1 1 1 1 1 1 26 1 1 1 6 7 0 0 8 
8 8 8 8 8 8 8 8 8 8 8 8 8 8 8 8 8 8 8 8 8 8 8 8 8 8 8 8 8 8 8 8 8 
