33 7 25 1 33
0 1 1 1 1 1 0 0 0 1 1 1 1 1 0 0 0 0 0 0 2 3 3 4 5 
6 7 7 7 7 7 8 8 6 7 7 7 7 7 8 8 8 8 8 8 9 10 10 11 5 
12 13 12 12 12 12 7 7 12 13 12 12 12 12 7 7 7 7 14 14 15 16 17 18 5 
13 19 13 13 13 13 13 13 13 19 13 13 13 13 13 13 13 13 19 20 21 22 17 11 5 
23 24 25 23 23 25 23 25 23 24 25 23 23 25 23 25 25 26 24 27 28 29 30 31 5 
32 32 32 32 32 32 32 32 32 32 32 32 32 32 32 32 32 32 32 32 32 32 32 32 5 
5 5 5 5 5 5 5 5 5 5 5 5 5 5 5 5 5 5 5 5 5 5 5 5 5 
