25 6 25 1 25 32 32
0 1 1 1 1 1 0 0 0 1 1 1 1 1 0 0 0 0 0 0 2 3 3 4 5 
6 6 6 6 6 6 1 1 6 6 6 6 6 6 1 1 1 1 1 1 7 8 8 9 5 
6 10 6 6 6 6 6 6 6 10 6 6 6 6 6 6 6 6 10 10 11 12 8 4 5 
10 13 10 10 10 10 10 10 10 13 10 10 10 10 10 10 10 10 13 14 11 4 8 9 5 
15 16 17 15 15 17 15 17 15 16 17 15 15 17 15 17 17 18 16 19 20 21 22 9 5 
23 23 23 23 23 23 23 23 23 23 23 23 23 23 23 23 23 23 23 23 23 23 23 23 24 
