51 13 49 1 51 16 16
0 0 0 0 1 2 3 3 4 5 3 3 6 7 8 9 0 0 0 0 0 0 0 0 0 0 0 0 0 0 0 0 0 0 0 0 0 0 0 0 0 0 0 0 10 11 12 13 14 
0 0 15 16 17 1 3 3 18 19 3 3 6 7 20 21 15 16 15 16 15 16 15 16 3 3 3 3 15 16 3 3 15 16 15 16 3 3 15 16 3 3 15 16 22 23 12 13 14 
0 0 16 24 3 3 1 2 3 3 3 3 6 7 25 26 16 24 10 11 27 28 16 24 4 5 10 11 27 28 8 9 16 24 10 11 27 28 4 5 10 11 27 28 29 30 12 13 14 
0 0 31 16 3 3 17 1 3 3 3 3 6 7 32 33 31 16 22 23 23 34 31 16 18 19 22 23 23 34 20 21 31 16 22 23 23 34 18 19 22 23 23 34 35 36 12 13 14 
0 0 3 3 3 3 3 3 1 2 4 5 6 7 16 24 4 5 23 23 23 23 4 5 16 24 37 23 38 39 25 26 3 3 37 23 23 23 16 24 23 23 23 23 16 24 12 13 14 
0 0 3 3 3 3 3 3 17 1 18 19 6 7 31 16 18 19 40 41 42 39 18 19 31 16 43 23 44 44 32 33 3 3 43 23 45 23 31 16 40 41 42 39 31 16 12 13 14 
0 0 4 5 3 3 0 0 0 0 0 0 6 7 29 30 16 24 29 30 38 39 16 24 4 5 46 23 44 44 16 24 3 3 46 23 46 23 4 5 23 23 44 44 3 3 0 0 14 
0 0 18 19 3 3 15 16 15 16 15 16 6 7 35 36 31 16 35 36 44 44 31 16 18 19 47 23 44 44 31 16 3 3 47 23 47 23 18 19 40 41 44 44 3 3 44 48 14 
0 0 0 0 3 3 4 5 3 3 16 24 6 7 16 24 4 5 0 0 16 24 3 3 3 3 0 0 16 24 4 5 3 3 16 24 16 24 16 24 16 24 3 3 3 3 44 49 14 
0 0 15 16 3 3 18 19 3 3 31 16 6 7 31 16 18 19 15 16 31 16 3 3 3 3 15 16 31 16 18 19 3 3 31 16 31 16 31 16 31 16 3 3 3 3 44 50 14 
0 0 3 3 0 0 0 0 3 3 3 3 6 7 3 3 3 3 3 3 3 3 3 3 3 3 3 3 3 3 3 3 3 3 3 3 3 3 3 3 3 3 0 0 0 0 0 0 14 
0 0 3 3 15 16 15 16 0 0 0 0 0 0 0 0 0 0 0 0 0 0 0 0 0 0 0 0 0 0 0 0 0 0 0 0 0 0 0 0 0 0 0 0 0 0 0 0 14 
14 14 14 14 14 14 14 14 14 14 14 14 14 14 14 14 14 14 14 14 14 14 14 14 14 14 14 14 14 14 14 14 14 14 14 14 14 14 14 14 14 14 14 14 14 14 14 14 14 
