44 13 49 1 44 16 16
0 0 1 2 3 3 3 3 1 2 4 4 4 4 4 4 4 4 4 4 4 4 4 4 4 4 4 4 4 4 4 4 4 4 4 4 4 4 4 4 4 4 4 4 4 4 0 0 5 
0 0 6 1 3 3 3 3 6 1 4 4 4 4 4 4 4 4 4 4 4 4 4 4 4 4 4 4 4 4 4 4 4 4 4 4 4 4 4 4 4 4 4 4 4 4 0 0 5 
0 0 3 3 3 3 7 8 3 3 4 4 4 4 4 4 3 9 3 9 4 4 4 4 4 4 4 4 10 11 4 4 4 4 4 4 4 4 4 4 4 4 3 9 3 9 0 0 5 
0 0 3 3 3 3 12 13 3 3 4 4 4 4 4 4 3 3 3 3 4 4 4 4 4 4 4 4 14 15 4 4 4 4 4 4 4 4 4 4 16 17 3 3 3 3 0 0 5 
0 0 3 3 3 3 1 2 3 3 4 4 4 4 10 11 18 19 20 21 10 11 4 4 4 4 4 4 22 23 3 9 3 9 3 9 3 9 24 17 25 25 7 8 3 3 0 0 5 
0 0 3 3 3 3 6 1 3 3 4 4 4 4 14 15 26 4 4 27 14 15 4 4 4 4 4 4 28 3 3 3 3 3 3 3 3 3 25 25 25 25 12 13 3 3 25 29 5 
0 0 3 3 7 8 22 23 0 0 4 4 20 21 0 0 4 4 4 4 3 3 10 11 10 11 3 9 30 31 3 3 3 3 0 0 32 33 1 2 7 8 3 3 3 3 25 34 5 
0 0 3 3 12 13 28 3 0 0 4 4 4 27 3 3 35 36 4 4 3 3 14 15 14 15 3 3 37 38 0 0 3 3 39 1 40 32 6 1 12 13 3 3 0 0 25 41 5 
0 0 3 3 22 23 3 3 3 3 24 17 24 17 7 8 1 2 1 2 3 3 3 3 22 23 0 0 1 2 10 11 3 3 18 19 20 21 32 33 3 3 3 3 1 2 0 0 5 
0 0 3 3 28 3 3 3 3 3 25 25 25 25 12 13 6 1 6 1 3 3 3 3 28 3 39 1 6 1 14 15 3 3 26 4 4 27 40 32 3 3 0 0 6 1 0 0 5 
0 0 0 0 42 0 7 8 7 8 0 0 0 0 0 0 0 0 0 0 10 11 0 0 3 3 4 4 0 0 3 3 3 3 4 4 10 11 0 0 0 0 3 3 3 3 0 0 5 
0 0 0 0 1 43 12 13 12 13 3 3 39 1 39 1 39 1 3 3 14 15 39 1 3 3 35 36 39 1 0 0 0 0 35 36 14 15 39 1 39 1 3 3 3 3 0 0 5 
5 5 5 5 5 5 5 5 5 5 5 5 5 5 5 5 5 5 5 5 5 5 5 5 5 5 5 5 5 5 5 5 5 5 5 5 5 5 5 5 5 5 5 5 5 5 5 5 5 
